############
#d r   p r #
#  s ##### #
#sss #   x #
############