########################
#d r p r r #      g    #
#  s ##### #        ####
#sss #   x             #
#                      #
#        b          ####
#                   # x#
########################