################## #####
#d r p r r #           #
#  s ##### #           #
#sss #   x             #
#                       
                       #
#                      #
################## #####