############
#d r   prr #
#  s ##### #
#sss #   x #
############